1,S,1,1,1,1
1,0,1,1,1,1
1,O,1,1,1,1
1,C,1,1,1,1
1,0,1,1,1,1
1,O,1,1,1,1
1,O,1,1,1,1
1,C,1,1,1,1
1,E,1,1,1,1