1,S,0,0,O,1
1,0,0,0,C,1
1,C,0,0,0,1
1,C,0,0,0,1
1,O,1,0,1,1
1,C,O,0,1,1
1,0,O,C,1,1
1,0,C,0,1,1
1,1,0,0,E,1